NO north.png
SO south.png
WE west.png
EA east.png

F 220,100,0
C 225,30,0

111111
100101
1010@1
1100N1
111111