NO north.png
SO south.png
WE west.png
EA east.png

F 220,100,0
C 225,30,0

111111
1S0101
101001
1100N1
111111