NO north.png
SO south.png
WE west.png
EA east.png

F 100,100,100
C 200,200,200

   11111
  1000011
  1010001
 100111011
10001 1001
10001  101
1011  1001
101  100011111
1011 100100001
100011101010001
 1001 10001010111
10001 111110000001
10W01   1011111101
 111    1000000001
         11111111 